1111111111111111111111111111111
1P010000000C00000100000000C0001
1000011111000000011000001000001
1C00110000001100000000000000001
10001000C0000000CCCCC0001000001
10011001C00C00000000C0000111111
10010001CCCCC000CCCCC0000001111
10010000010C1111C1000100000C001
10010000010C1000CCCCC0000011111
1001001000000000000000011110011
10000010111111111100000000000E1
10C001101000000C000000000000011
1111111111111111111111111111111
