1111111111111111111111111111111
1P010000000C00000100000000C0001
1000011111000000011000001000001
1C0011C0000011000100C0000000001
1000100110000000R00000001000001
100110010000C000001110000111111
1001000000000000000000000001111
10010C000111111111000100000C001
1001000001111000000000000011111
1001001000000000C00000011110011
10000010111111111100000000000E1
10C001101000000C000000000000011
1111111111111111111111111111111
