111111111111111111111111
1P00000000000000000000C1
111111111111111111111101
100E000000000C0000000001
111111111111111111111111
