1111111111111
11R10000000C1
1000011111001
1P0011E000001
1111111111111
